SSSUUUUUUUUUUOUUUUUU
SSSUUOUUUUUUUOUUUUUU
SSSUUUUUUUUUUOUUUUUU
UUUUUUUUUUUUUOUUUUUU
UUUUUUUUUUUUUOUUUUUU
UUUUUUUUOUUUUOUUUUUU
UUUUUUUUOUUUUUUUUUUU
UUOUUUUUOUUUUUUUUOUU
UUUUUUUUUUUUUUUUUUUU
UUUUUUUUUUUUUUUUUUUU
UUUUUUUUUUOUUUUUUUUU
UUUUOUUUUUUUUUOUUUUU
UUUUOUUUUUUUUUOUUEEE
UUUUOUUUUUUUUUOUUEEE
UUUUUUUUUUUUUUUUUEEE