SSSUOOOOOOUUUUUUOUUU
SSSUUUUUUUUUUUUUOUUU
SSSUUUUUUUUUUUUUOUUU
UUUUUUUUUUUUUUUUUUUU
UUUUUUUUUUUUUUUUUUUU
UUUOUUUUUUUUUOUUUUUU
UUUOUUUUUUUUUOUUUUUU
UUUUUUOUUOUUUOUUUUUU
UUUUUUOOOOUUUUUUUUUU
UUUUUUUUUUUUUUUUUUUU
UUOUUUUUUUUUUUUUUUUU
OOOUUUUUUUUUUUUUUUUU
UUUUUUOOUUUUOOUUUEEE
UUUUUUUOUUUUUOUUUEEE
UUUUUUUOUUUUUOUUUEEE