SSSUUUUOUUUUUUUUUUUU
SSSUUUUOUUUUUUUUUUUU
SSSUUUUOUUUUUUUUUUUU
UUUUUUUUUUUUUUUUUUUU
UUUUUUUUUUUOOUUUUUOU
UUUUUUUUUUUOOUUUUUUU
UUUUUUUUUUUOOUUUUUUU
UUUUUUUUUUUOOUUUOUUU
UUUOOOUUUUUOOUUUUUUU
UUUUUUUUUUUOOUUUUUUU
UUUUUUUUUUUUUUUUUUUU
UUUUUUUUUUUUUUUUUUUU
UUUUUUUUUUUUUUUUUEEE
UUUUUUUUUUUUUUOUUEEE
UUUUUUUUUUUUUUUUUEEE