SSSUUUUUUUUUUUUUUUUU
SSSUUUUUUUOUUUUUUUUU
SSSUUUUUUUUUUUUUUUUU
UUUUUOUUUUUUUUUUUUUU
UUUUUOUUUUUUUUOOOUUU
UUUUOOUUUUUUUUUUUUUU
UUUUUUUUUUOUUUUUUUUU
UUUUUUUUUUOUUUUUUUUU
UUUUUUUUUUUUUUUUUUUO
UUUUUUUUUUUUUUOUUUUU
UUOOOOUUUUUUUUOUUUUU
UUUUUUUUUUUUUUOUUUUU
UUUUUUUUUUUUUUOUUEEE
UUUUUUUUUUUUUUOUUEEE
UUUUUUUUUUUUUUOUUEEE