SSSUUUUUUUOUUUUOUUUU
SSSUUUUUUUOUUUUOUUUU
SSSUUUUUUUOUUUUOUUUU
UUUUUUUUUOOUUUUOOUUU
UUUUUUUUUUUUUUUUUUUU
UUUUUUUUUUUUUUUUUUUU
OUUUUOUUUUUUUUUUUUUU
OUUUUOUUUUUUUUUUUUUO
OUUUUOUUUUUUOOOUUUUU
UUUUOOUUUUUUOOOUUUUU
UUUUUUUUUUUUUUUUUUUU
UUUUUUUUUUUUUUUUUUUU
UUUUUUUUUUUUUUUUUEEE
UUUUUUUUUUUUUUOUUEEE
UUUUUOOOUUUUUUOUUEEE